ronós → ronós → ronós → ronós
hadsón → hadsón → hadsón → adsón
ᵐbxᵐbxtí → ᵐbxᵐbxtí → bemetí → bemethí
k̂elepw → selepw → thelepu → thelefhu
slkmó → salmkó → thalmkó → thalhó
phbsé → phbsé → pebsé → fhebsé
marlón → marlón → marlón → malón
ulésin → ulésin → uléthin → uléthin
khdéur → khdéur → kedéur → hedéur
kesa → kesa → ketha → hetha
rbxaren → urbxaren → urbxaren → urbaren
yoĝam → yozam → yozam → yozam
ĝlka → zalka → zalka → zalha
heisin → heisin → heithin → eithin
swosam → swosam → swotham → swotham
gʷnsap → gensap → gensap → gensafh
dāts → dāts → dāts → dāths
bekʷhg → bekhg → bekeg → beheg
tmngwa → temengwa → temenga → themenga
hk̂rgar → hsurgar → athurgar → athurgar
ᵐbalarhg → ᵐbalarhg → balareg → balareg
haserw → haserw → hatheru → atheru
loraᵑgwe → loraᵑgwe → loraxe → lorae
drbwar → durbwar → durbwar → durbwar
reikwar → reikwar → reikar → reihar
hᵑgmen → hmᵑgen → amᵑgen → amᵑgen
nrhno → enurhno → enureno → enureno
lerya → lerya → lerya → lerya
ᵐbaᵐbatweh → ᵐbaᵐbatwah → bamatwah → bamathwa
weu → weu → weu → weu
hēm → hēm → hēm → ēm
k̂a → sa → tha → tha
kek̂ → kes → kes → hes
hōp → hōp → hōp → ōfh
yona → yona → yona → yona
pei → pei → pei → fhei
ᶮĝax → nzax → nzax → nza
yok̂ → yos → yos → yos
lein → lein → lein → lein
teus → teus → teus → theus
yōn → yōn → yōn → yōn
ⁿdelosgar → ⁿdelosgar → delosgar → delosgar
weyaw → weyaw → weyei → weyei
ᶮĝnrna → nzenurna → nzenurna → nzenula
sok̂ren → sorsen → thorsen → thorsen
yabarge → yabarge → yabarge → yabarge
modra → morda → morda → morda
popemw → popemw → popemu → fhofhemu
nmĝ → enemz → enemz → enemz
hotat → hotat → hotat → othath
hams → hams → hams → ams
dow → dow → dei → dei
hotant → hotant → hotant → othanth
yoms → yoms → yoms → yoms